0000100100100000000000000000000000000000000000000000000000000
0000000100100000110001000000010000000000000000000000000000000
1000000111011000000000100000011011000000000000000000001000000
1000000110001000000000100000011011000100000000000000001000000
0000110101000000000000000000000000000000000000000000000000000
0000000100100000110001000000010000010000000000000000000000000
1000000110011000000000100000011011000011000000000000001000000
1000000101111000000000100000011011000111000000000000001000000
1000001010001000000001000000100000110010000000000000001000000
0000000100100000110001000000010000100000000000000000000000000
0001001001100000000000000000000000000000100010100100010100000
0001001001100000000000000000000000000000100010100100010100000
0000000100100000001000001000011000000000000000000000000000000
0000000100100000110000010000010000000000000000000000000000000
0000000100100000100000100000000101000001000000000000000000000
1000000111001000000000100000000000000010000000000000001000000
0000010100000000000000000000000000001110000000000000000000000
0000010100010000000000000000000000001100000000000000000000000
0001011001001000001100000000000000000000000000000000001000000
0001011001001000001100000000000000000000000000000000001000000
0000000100100000101100001001011000000000000000000000000000000
0000000100100000101100001001000110000001000000000000000000000
0000000100100000001000001000000100000001000000000000000000000
0000000100000100000001000000000000110010000000000000000000000
0000000100010100000001000000000000110000000000000000000000000
0000010110010100000000000000000000001010000000000000000000000
1000001100001000100000000010100000000010000000010001001000000
0000000100100000110010000000000000000010000000000000000000000
0000010111000100100100000001000000001010000000000000000000000
0000010111010100000000000000000000001000000000000000000000000
0000000100100000001010000100000000000010000000000000000000000
0000000100100000110010000000000000000000000000000000000000000
0010000000000001000000000000000000000000000100000000000000000
0000011000010100000000000000000000001010000000000000000000000
0000001010010100000000000000000000000000000001000000000000000
0000001000000010000010000000000000000010000000000000000000000
1000001000010000000000000000000000000010000000000000000000000
0000011001010000000000000000000000001110000000000000000000000
1000001110101000100000000010100000000110000000010010001000000
1000001000101000100000000010100000000110000000010010001000000
0000011010000100000000000000000000001010000000000000000000000
0000011010010000000000000000000000001110000000000000000000000
0000000110100000001010000100000000000010000000000000000000000
1000001011011000000000000000000000000010000000001000001000000
0001001101100000100000000010100000000000000000010001000000000
0000011011010100000000000000000000001010000000000000000000000
0000001001100000100000000010100000000000010000010011000000000
0000000100100000001010000100000000000010000000000000000000000
0000011100000100000000000000000000001010000000000000000000000
0000011100010100000000000000000000001011000000000000000000000
0000001011000000010010000000000000000010100000000000100000000
0001111101010100000010000000000000000011000100000000000000010
0001001001100000000000000000000000000000100010100100000100000
0000011101010000000000000000000000001110000000000000000000000
0001011001001000001100000000000000000000000000000000001000000
0100000000001000000010000000000000000010000000000000000000001
0001101100011000000000000000000000000011000100000000000010000
0000011110010100000000000000000000001000000000000000000000000
0000001001010100000000000000000000000000000000000000000001000
0001111101010100000010000000000000000010000100000000000000100
0000000000000000000000000000000000000000000000000000000000000
0001101110011000000000000000000000000000000100000000000010000
0000000100100000100000000010100000000000001000010000000000000
0001001001100000000000000000000000000000100010100100010100000
