0001001001000000000000000000000000000000000000000000000000000000000
0000001001000001100010000000100000000000000000000000000000000000000
0000010010010000000001000000110110000000000000000000011001000000000
0000010010010000000001000000110110000000000000000000011001000000000
0001101010000000000000000000000000000000000000000000000000000000000
0000001001000001100010000000100000100000000000000000000000000000000
0000010010010000000001000000110110000010000000000000011001000000000
0000010010010000000001000000110110000010000000000000011001000000000
0000010010010000000010000001000001100000000000000000001001000000000
0000001001000001100010000000100001000000000000000000000000000000000
0010010011001000000000000000000000000001000101001000100000000000000
0010010011001000000000000000000000000001000101001000100000000000000
0000001001000000010000010000110000000000000000000000000000000000000
0000001001000001100000100000100000000000000000000000000000000000000
0000001001000001000001000000001010000010000000000000000000000000000
0000010010010000000001000000000000000000000000000000001001000000000
0000101000000000000000000000000000011100000000000000000000000000000
0000101000100000000000000000000000011000000000000000000000000000000
0010110010010000011000000000000000000000000000000000011001000000000
0010110010010000011000000000000000000000000000000000011001000000000
0000001001000001011000010010110000000000000000000000000000000000000
0000001001000001011000010010001100000010000000000000000000000000000
0000001001000000010000010000001000000010000000000000000000000000000
0000001000001000000010000000000001100100000000000000000000000000000
0000001000101000000010000000000001100000000000000000000000000000000
0000101100101000000000000000000000010100000000000000000000000000000
0000010010010001000000000101000000000000000000100010001001000000000
0000001001000001100100000000000000000100000000000000000000000000000
0000101110001001001000000010000000010100000000000000000000000000000
0000101110101000000000000000000000010000000000000000000000000000000
0000001001000000010100001000000000000100000000000000000000000000000
0000001001000001100100000000000000000000000000000000000000000000000
0100000000000010000000000000000000000000001000000000000000000000000
0000110000101000000000000000000000010100000000000000000000000000000
0000010100101000000000000000000000000000000010000000000000000000000
0000010000000100000100000000000000000100000000000000000000000000000
0000011000110000000000000000000000000000000000000000000000001000000
0000110010100000000000000000000000011100000000000000000000000000000
0000010010010001000000000101000000000000000000100100001001000000000
0000010010010001000000000101000000000000000000100100001001000000000
0000110100001000000000000000000000010100000000000000000000000000000
0000110100100000000000000000000000011100000000000000000000000000000
0000001101000000010100001000000000000100000000000000000000000000000
0000010010010000000000000000000000000000000000010000001001000000000
0010011011000001000000000101000000000000000000100010000000000000000
0000110110101000000000000000000000010100000000000000000000000000000
0000010011000001000000000101000000000000100000100110000000000000000
0000001001000000010100001000000000000100000000000000000000000000000
0000111000001000000000000000000000010100000000000000000000000000000
0000111000101000000000000000000000010100000000000000000000000000000
0000010110000000100100000000000000000101000000000001000000000000000
0000011100100000000100000000000000000100000000000000000010000000000
0010010011001000000000000000000000000001000101001000000100010000000
0000111010100000000000000000000000011100000000000000000000000000000
0010110010010000011000000000000000000000000000000000001000000000000
1100000000010000000000000000000000000000000000000000000000001000110
0000011010101000000000000000000000000100000000000000000000000010000
0000011100000000000000000000000000000000000000000000000000110000001
0000010010101000000000000000000000000100000000000000000000000100000
0000000000000000000000000000000000000000000000000000000000000000000
0000000000000000000000000000000000000000000000000000000000000000000
1011010000100000000000000000000000000000001000000000000000000000000
0000001001000001000000000101000000000000010000100000000000000000000
0010010011001000000000000000000000000001000101001000100000000000000
