000100100100000000000000000000000000000000000000000000
000000100100000110001000000010000000000000000000000000
000001001001000000000100000011011000000000000000000001
000001001001000000000100000011011000000000000000000001
000110101000000000000000000000000000000000000000000000
000000100100000110001000000010000010000000000000000000
000001001001000000000100000011011000001000000000000001
000001001001000000000100000011011000001000000000000001
000001010001000000001000000100000110000000000000000000
000000100100000110001000000010000100000000000000000000
001001001100100000000000000000000000000100010100100010
001001001100100000000000000000000000000100010100100010
000000100100000001000001000011000000000000000000000000
000000100100000110000010000010000000000000000000000000
000000100100000100000100000000101000001000000000000000
000000111001000000000100000000000000000000000000000000
000010100000000000000000000000000001110000000000000000
000010100010000000000000000000000001100000000000000000
001011001001000001100000000000000000000000000000000001
001011001001000001100000000000000000000000000000000001
000000100100000101100001001011000000000000000000000000
000000100100000101100001001000110000001000000000000000
000000100100000001000001000000100000001000000000000000
000000100000100000001000000000000110010000000000000000
000000100010100000001000000000000110000000000000000000
000010110010100000000000000000000001010000000000000000
000001100001000100000000010100000000000000000010001000
000000100100000110010000000000000000010000000000000000
000010111000100100100000001000000001010000000000000000
000010111010100000000000000000000001000000000000000000
000000100100000001010000100000000000010000000000000000
000000100100000110010000000000000000000000000000000000
010000000000001000000000000000000000000000100000000000
000011000010100000000000000000000001010000000000000000
000001010011000100000000010100000000000000000010010000
000001000000010000010000000000000000010000000000000000
101101000010000000000000000000000000000000100000000000
000011001010000000000000000000000001110000000000000000
000001001011000100000000010100000000000000000010010000
000001000100100000000000000000000000000000001000000000
000011010000100000000000000000000001010000000000000000
000011010010000000000000000000000001110000000000000000
000000110100000001010000100000000000010000000000000000
000001011011000000000000000000000000000000000001000000
001001101100000100000000010100000000000000000010001000
000011011010100000000000000000000001010000000000000000
000001001100000100000000010100000000000010000010011000
000000100100000001010000100000000000010000000000000000
000011100000100000000000000000000001010000000000000000
000000000000000000000000000000000000000000000000000000
000001011000000010010000000000000000010100000000000100
000000000000000000000000000000000000000000000000000000
001001001100100000000000000000000000000100010100100000
000000000000000000000000000000000000000000000000000000
001011001001000001100000000000000000000000000000000000
000000000000000000000000000000000000000000000000000000
000000000000000000000000000000000000000000000000000000
000000000000000000000000000000000000000000000000000000
001100111010000000000000000000000000000000100000000000
001100110010000000000000000000000000010000100000000000
000000000000000000000000000000000000000000000000000000
000000000000000000000000000000000000000000000000000000
000000100100000100000000010100000000000001000010000000
001001001100100000000000000000000000000100010100100010
